11111111
10000001
100EPC01
11111111
11111111