1111111111111111111111111
100000000CEP0000000100001
1111111111111111111111111