11111111111111111111111111111111111
1000010000C000C00000000001000000001
1000010100100C001010000010000101011
100C00010101010010110000000P0110111
100001000001010000C1000C000EC000011
11111111111111111111111111111111111