111111111111111
10P1010000E0001
10C00100000C001
1000C0000C00001
111111111111111
