1111111111111
10011100000C1
1010010)11101
101E11e0P0001
1111111111111