1111111111111
1EP00000C0001
1111111111111