111111111111111
10P00000C000001
10000E000000001
10000000CCC0001
111111111111111