111111111111111
10P00000C000001
10000E000000001
100000000000001
111111111111111