1111111111111
10011000000C1
101E010111101
101E1100P0001
1111111111111