1111111111111
10010000000C1
100t011111001
1P0011E000P01
1111111111111