1111111111111
1EP0000000001
1000000000001
1000000000001
1000000000001
1000000000001
100000C000001
100000C000001
100000C000001
10C0000000001
10000C0000001
1000000000001
100CCCCCCC001
1CCCCCCCCCCC1
100CCCCCCC001
1000000000001
1111111111111