1111111111111
10010000000C1
10PQ011E11101
1010110000P01
1111111111111