111111111111111111111111
100000P00000001C10000C01
101001010010000010100101 
101001001010101000100101
100000000C00C00000000001
111111111111111111111111