1111111111111111111111111111111111
100000P00000001C10000C000000C00011
1010010100100000101001000000011E01  
1010010010101010001001000000010101
100000000C00C000000000000000000001
1111111111111111111111111111111111