1111111111111111111
10000PEC0C000000001
1111111111111111111