1111111111111111111
1000CPCC0C000000EC1
1111111111111111111