11111111111111111111111111111111111
1P00011C111111111111111111111111C01
11110010100001101000011000010000101
1E101010110100100011C11101010110001
101100100001000000100C0000010011111
1000100011101111C00C011001000011111
1000000000001010000001C00000000C001
11111111111111111111111111111111111
