1111111111111
100E0P00000C1
1000000000005
10000000C0001
1000000CC0001
5555555555555