1111111111111
100E0P00000C1
1111111111111