11111111111111
100000C0010C01
100E0P00000001
1C000000100001
11111111111111

