1111111
1000001
1EPC111
1111111