1111111111111111111111111111111111111111111111111111111111111111111111111111111111111111111111111111
1P00000000000000000000000000000000000000C00001001100011000110011111100000101110110000101101100100011
1110110000010101010100000000100010000111011101101101000000100011101101100011001101111010111010100111
1000010101011010111010001010111010110110101010011111111100110110001110010000110001001110100010010101
1000000110000111111111011110111000000011110111011010011111101011011000000011011010000100110011000001
1000100101001011010010111010011100000010001001011001010101100011000011100110100001000010010010110011
1000111100000001111101111010101101011011001000101010101011010101111011110110010000010111110110101011
1111011010010000100101101100011101010110000111001100100000000010111010111010011010110000010101000011
1001100011001111111111000000000001000101110001010000101000110000000110100111110000000111101100010101
1110001010000011101111000100011000000100011100110100111000010001111101001101000110110101001110101111
11101001010100010001010111010010101110111101101100100111001011111100000110101100C1100110101001011111
1001100101011101101101010001010010000101100000111111110111010011000100101101011000110000000001011111
1110101010000111111111000100010000111000000010000100111011011010010000001001100101100110000001000111
1100000001001001011110110101001101110110010001111011101000011110111001011100111000011010101110111101
100C000000001010000110011000100001011011001101110111111101001110101110111110001001110111111101011111
1010110101000000000000000000000000000000110100111111010110001101101011111100001101011111110111110111
1001100010001101110100001011111100000110000000111011000011110101100100010101111100101110000101110001
110011000101111101111110101100100110000000000000000000000000C101010010001001101001011001001100101111
1001000011000110000001110000101010101101111001000000000100001100111011101001010101101111010010110001
1101011001111001100111111010010101100011011010100000100001001100000101100010011001100010110100001111
1111010100111101001101010000101101001111011010100100010000101010011110001110011101010010001010110001
1111101110111000100011100101101001100110111110101110111011110000010111100011011000010000110001100101
1101010011111000100110011110110001001010111000001100110010110010111001000011001100011101010011000111
1110101111001101001011101110000001000001000111110011000100111000010111010001000000111001001110100011
1000010101001110111000100100110110000111111011111110001010011010010001100110011100111000100001110011
1111001010010000001011001011010100101010001000110001101011011110010011101100101000110011001101011001
1110011011111010011010000001100000101110100100001001111001010110110001110111001000001101000001110111
1000011100100000001001111110010110101100011001001111110011001110110011111100101000100101010001111111
1001111111011011110001110101110000100000010010010111111111111011011110111110011000010110101001111101
1011111111111001100000110010000111001111111001110111110010111101011111110011111100010101011001101111
1001100010010001110000010011110110101001011011011110101001011101001100001000011101100111001111100101
1111011110010001101010110101111011001110100111111001000010110010100101001000100001010101100001111011
1000000011100111000111000111111000001010101010011100101110010000101110100100011000101001101000000011
1001101011111111000111000110000011100101010000001001101110000101101010011010001101001110001110001011
1000010101011011001110011011100011100001110000000110110111001001101100000011001001100100101000011001
1110100100110110101111000000111101101001111011000000110100010111111011010001101100000100111111101101
1001010111100010000101111100001100000101111100001111101000111101000000010001011101001111100001000101
1101000111101010111110010001100000000110101011111000111111001111001001111111100001101110101100110001
1110010001001101111001110010001101101001100111101010011011110000010100100101011000101000110010010011
1110000110101011001111101100001110100001110110101010110111100011000011111111001101011011001001110011
1001010110100111010110001010111001101010101000101001000001010111111011111101100101111001000110100001
1001110100000011011100101111100110000011000000100001000111011100011000110000001101010010100001101111
1100111111001001000111110100000001000101000111000101000001110010101110100110100000100011010110001101
1111001011110110101111110100100010000111011100101011101010101011110101101001010100111001101100000001
1100100110111010000110101110101000101011101001010011000110011100001101101011110001110010001101111001
1101100011000110100101000100111101101111100000101001011010000110111100001110110100100001000101011111
1100101001101100000000110110000110000100101001011100000011100000110010111011001100000111011101001111
1010001110011011001001001011011100100000011101110110000011101010001010000000111001011011011101111111
1101111010101111100010011001001001000101100111001001101000010001001000110101000100101101000101011101
1111101001001001110101111000110010100000110001100001011100010010111110011101000000011011100100110011
1000110101011001110110001001100010000100000001111000100110001010010001100011101101000010110110111011
1001101010111111111001001010110011100101001100111100100100000011101010111101100001110011100010010111
1110010010110001110110101100100101101100010010101101011100011011101101011100011001000001000101000101
1010100100100000001110000111010100101001001111101100110100100111100010110110111001110110011110110011
1010111010110100011001010101011010001001011000110010000110101100001001010010111100000000110011110001
1011101010C00000000000000000000000001110110110001110101001010111001011110011111101011010100010110111
1001110101000000100001011011010001000000000000000000000000000000000111101010001001000100110000111111
1100001111001110001110100001011011100111100001010000111010111011101011101010111001110010111010111101
111010111110100110111010100100010110011011100000011000001111110000000000000000000000000000C101001011
1111100111100001001101101110101111010010101111010000000100011100000000010110011101011100010110000011
1100001110100111111111101100001101001101110110001010100111000000100000000000000000000110110101011011
1001001111100100010010111011100101010110100010101010101011110000001000100001010100000110000001111011
1011000011001100001100100010100111100110110110101011001111000001100110011100101100111100111011101101
1110110011101110011101110010011011000110000010000111011011111101011100011011110000101001000101110001
1100101100000000111101000100100111011100111111110110011101101111110101011010000000101110100001100101
1011110000101010011100110110001011011101111001010111101100000100010111001001101100100001010111111101
1011110100001011100010110011100111101011011010101011001001011011110011100011110001011110101101110011
1001110100001000000100011110100100000101011011010110011000100010110011010100110100000010101101100111
1110010001101000010011001100110010000111100000111111100011011110000100110011100100111001010000111101
1001110001100101010011101010000111111001100011111110001010011000001100111010111000001100100000111001
11000101111C1101110011011001010100110000011011000001110010110000100101100000111001110001010000110101
1010111000111110110011010111110100000110100111010010100100001110011010110000010001111001110110011101
1101001101101010011010111010100100011101001101001000011001011010010011100011101100011001100010111011
1100111010111110010011100100100001101010010011001110000101010101101010001000101000101011100100000011
1100100100001101000101101011001111011100010101000111001110001000100101111110001000101001001100001111
1000010110111011111110101001010001110101100011001110111101111001111100011000010000111101101111001011
1000110011110010111010010011100110000110101111110000000101011000010110101100001101100111000100011101
1111101110001011000010110001101000110101111110000011000101110111010111101011111000011001100110000111
1100001111101101101101001000100100110001110110001100011110011001101100000010001000110010110011111011
1000111111C00000000000000000000000000000000000000000000000000000000000000000000001010011101011111011
11001100110011110001010011001110001101000000011010010001100010011111000001001011000000000000000E0001
1101000101000100110101101010101110110001001111000110101010010100111000100110100001000111100110110011
1100101011111110110100110001011010001111110101110011000001001101001000011010111001000000001111001101
1111001100110000110001001111001000001011000111111111001100111000011111111011000111101110110000010001
1011000011101100010010010001100110000110111100001010100110000101110011101101001001111101010110011111
1000101000101010011111111111000010000000011100000111110101000100010010100101001100011111011111011101
1000001000011100001001101111110011010001011110011010111001001001001100111111111010101011100111101011
1101110110100000000100001010110010100010110101100101010011111001101100100011101010000000111001001001
1010111100110100101101101011010011111001000110111101011011010011010100111010101101010110100110110001
1011001001000000000111011001011110110110101000111110001101010101101011100100100011001001110100011011
1011000010110011101111111010100110011100110101010000111011100011011001111001000010000011111011011011
1101110110111111000000001000111000000110001001100100001111111110010110000001100010011000001101101111
1001011111000000001101001110100100000111101101001001010001101000101010010101001100111111010001111111
1110111111111110100011100001000000100001110110011111000001101100010001100100011011000001100100110111
1100000111000011111100001001100000010000111000100100111101100001111110101111101111110110011101100011
1001011000011101110000101110111001011101111001101011111101000001111100000000010011011001000100100101
1101011111111010001101101001101111101100101010110010000110110101110001001001000110000100001110110001
1010010111110001111100101001111101100111000110010000000110001011001101101001100111011101001111101011
1011010001001111011101101111101000111010001000111101110001111010010100110000100101001110001110101111
1111111111111111111111111111111111111111111111111111111111111111111111111111111111111111111111111111