111111
1CPE01
111111
100001
100001
111111