1111111111111111111111111111111111111111111111111111111111111111111111111111111111111111111111111111
1P0C000000000000000000000000000000000000C010111011000110110000101001001100100100C1010110010111000111
1111101100000000000000000000000000000101010111011001000000100111100000000001101101000010110011110001
1101110110010110011011011001000100101100011001111011110010000000000011011110000001001011001111110111
110111111011010010101100001100001000000000000000000000000000C011000011001000011100111111110010011101
1001001010C00000000000000000000000001110101001010110000101010011101101101101001000111100110100001101
1110100011000110101110010010100010000000000000000000000000000000000000000000000001110000111101111111
1001111000C00000000000000000000000000000000000000000000000000000000000000000000000100100011001010001
101000010100111111011011110101100011000000110111110110101111100000000000000000000000000000000E011111
1111111111111111111111111111111111111111111111111111111111111111111111111111111111111111111111111111
